...............
...............
...%%%.........
...%%%...%%%...
.........%%%...
...............
...............
...............
...............
...............
...............
.....%...%.....
.....%...%.....
..%..%...%..%..
..%..%...%..%..