..%%%%%......%%
..%%.........%%
...%........%..
...%.......%...
..........%....
...............
.......%.......
......%%%......
.......%.......
...............
....%..........
...%.......%...
..%........%...
%%.........%%..
%%......%%%%%..