%%...........%%
%.............%
%.............%
......%%%......
.......%.......
.......%.......
.......%.......
...%...%...%...
......%%%......
...............
.......%.......
......%%%......
%....%%%%%....%
%%%%%%%%%%%%%%%
%%%%%%%%%%%%%%%