...............
...............
...............
..%%%%...%%%%..
...%.......%...
...%.......%...
...............
...............
...............
...............
..%%%%%.%%%%%..
.....%...%.....
.....%...%.....
...............
...............